F 235,242,249
	NO images/combo/lion.xpm
  WE		 images/combo/brick.xpm    
  		EA 	images/combo/blue_ice.xpm				

C          115,122,132

SO images/combo/white_ice.xpm


111111111
100000001
100000001
101101101
101101101
101101101
100000001
101101101111
10110110  11
1011011011 1
111000000001
10N00000111
 1111111