NO textures/horror/horror2.xpm
WE textures/horror/horror4.xpm    
EA textures/horror/horror3.xpm		
SO textures/horror/horror1.xpm

F 5,5,5		
C 124,10,2

11111111111
10001000011 
11000000011
11000000011
11000000011
11000000011
11000010011
11000000011
11001110011
1000N0011
1111111111111