            
            
            
            NO              textures/skull.xpm





SO              textures/nun.xpm
WE textures/skull_wall.xpm
EA textures/ugly.xpm
F 20, 25, 9
C 0,0,0


111111111111
1 1   111111
1 N011111111
100011111111
111111111111