C 1, 1, 1
F 1, 2, 1


            NO              textures/a_bit_darker_greyish.xpm.xpm
SO              textures/exit0.xpm
WE textures/exit1.xpm
EA textures/exit2.xpm



11111111111
10000100011 
1110010   0001
1000000N01
11111111111