NO /Users/ayal-ras/Desktop/Student/cub3D/textures/a_bit_darker_greyish.xpm
SO /Users/ayal-ras/Desktop/Student/cub3D/textures/a_bit_darker_greyish.xpm
WE /Users/ayal-ras/Desktop/Student/cub3D/textures/a_bit_darker_greyish.xpm
EA /Users/ayal-ras/Desktop/Student/cub3D/textures/a_bit_darker_greyish.xpm



C HELLO
F HELLO
11111111111
100001000S1
11100100001
10000000001
11111111111