



C 097,67,245
F 245,        245,    245


            NO              /Users/ayal-ras/Desktop/Student/cub3D/textures/a_bit_darker_greyish.xpm.xpm
SO              /Users/ayal-ras/Desktop/Student/cub3D/textures/exit1.xpm
WE /Users/ayal-ras/Desktop/Student/cub3D/textures/exit1.xpm
EA /Users/ayal-ras/Desktop/Student/cub3D/textures/exit1.xpm




11111111111
100001000S1
1110010   0001
10000000001
11111111111