m
            NO              textures/3_grey_pyramid.xpm
SO              textures/grey_pyramid.xpm
WE textures/2.xpm
EA textures/4.xpm
F 124,78,2		
C 0,0,0



        1111111111111111111111111
        1000000000110000000000001
        1011000001110000000000001
        1001000000000000000000001
111111111011000001110000000000001
100000000011000001110111101111111
11110111111111011100000010001
11110111111111011101010010001
11000000110101011100000010Y01
10000000000000001100000010001
10000000000000001101010010001
11000001110101011111011110N0111
11110111111101011111111000001
11111111111111111111111111111