



C 097,67,245
F 245,        254,    245


            NO              /Users/ayal-ras/Desktop/Student/cub3D/textures/a_bit_darker_greyish.xpm.xpm
SO              /Users/ayal-ras/Desktop/Student/cub3D/textures/exit1.xpm
WE /Users/ayal-ras/Desktop/Student/cub3D/textures/exit1.xpm
EA /Users/ayal-ras/Desktop/Student/cub3D/textures/exit1.xpm




11111111111
10000100011 
1110010   0001
1000000N01
11111111111
