C 1, 1, 1

            NO              textures/a_bit_darker_greyish.xpm.xpm
SO              textures/exit0.xpm
WE textures/exit1.xpm
EA textures/exit2.xpm
F 1, 2, 1



11111111111
10000000011 
11111100011
1000000E1
1111111111